x_x_x_x_x_x_x_x_x_x_x_x_x_x_x_x_x_x_x_x_x_x_x_x_x_x_x_x_x_x_x_x_x_x_x_x_x_x_x_x_x_x
x_x_x_x_x_x_x_x_x_x_x_x_x_x_x_x_x_x_x_x_x_x_x_x_x_x_x_x_x_x_x_x_x_x_x_x_x_x_x_x_x_x
x_x_x_x_x_x_x_x_x_x_x_x_x_x_x_x_x_x_x_x_x_x_x_x_x_x_x_x_x_x_x_x_x_x_x_x_x_x_x_x_x_x
x_x_x_o_o_o_o_o_o_o_o_o_o_o_o_o_o_o_o_x_o_o_o_l_l_o_o_o_o_o_o_o_x_o_o_o_o_o_o_x_x_x
x_x_x_o_o_o_l_l_l_o_o_o_o_o_o_o_o_o_o_!_o_l_o_o_l_o_o_l_l_l_o_o_@_o_o_o_o_o_o_x_x_x
x_x_x_o_o_o_o_o_o_o_o_o_o_o_o_o_o_o_o_x_o_l_o_o_o_o_o_l_o_o_o_o_x_o_o_o_o_o_o_x_x_x
x_x_x_x_)_x_x_x_x_x_x_x_x_x_x_x_x_x_x_x_x_x_x_x_x_x_x_x_x_x_x_x_x_x_x_x_x_x_x_x_x_x
x_x_x_o_o_o_x_x_x_x_x_x_x_x_x_x_x_x_x_x_x_x_x_x_x_x_x_x_x_x_x_x_x_x_x_x_x_x_x_x_x_x
x_x_x_o_l_o_o_o_l_o_o_o_l_o_x_o_o_o_o_o_o_o_o_l_o_o_o_o_x_o_o_o_o_o_o_o_o_o_o_x_x_x
x_x_x_o_l_l_o_o_l_o_l_o_l_o_9_o_o_o_o_o_l_o_l_o_o_l_o_o_8_o_o_o_o_o_o_o_o_o_o_x_x_x
x_x_x_o_o_o_o_o_o_o_l_o_o_o_x_o_o_o_o_o_l_o_o_o_o_o_l_o_x_o_o_o_o_o_o_o_o_o_o_x_x_x
x_x_x_x_x_x_x_x_x_x_x_x_x_x_x_x_x_x_x_x_x_x_x_x_x_x_x_x_x_x_x_x_x_x_x_x_o_o_o_x_x_x
x_x_x_x_x_x_x_x_x_x_x_x_x_x_x_x_x_x_x_x_x_x_x_x_x_x_x_x_x_x_x_x_x_x_x_x_o_o_o_x_x_x
x_x_x_x_x_x_x_x_x_x_x_x_x_x_x_x_x_x_x_x_x_x_x_x_x_x_x_x_x_x_x_x_x_x_x_x_o_o_o_x_x_x
x_x_x_x_x_x_x_x_x_x_x_x_x_x_x_x_x_x_x_x_x_x_x_x_x_x_x_x_x_x_x_x_x_x_x_x_o_o_o_x_x_x
x_x_x_x_x_x_x_x_x_x_x_x_x_x_x_x_x_x_x_x_x_x_x_x_x_x_x_x_x_x_x_x_x_x_x_x_o_o_o_x_x_x
x_x_x_o_o_o_o_o_o_o_o_o_o_x_o_o_o_l_o_o_o_o_o_l_o_o_o_o_o_o_o_o_o_o_x_o_o_o_o_x_x_x
x_x_x_o_l_o_o_o_o_o_o_o_o_6_o_o_o_l_o_o_o_o_o_l_o_l_l_o_o_o_o_o_o_o_7_o_o_o_o_x_x_x
x_x_x_o_l_o_o_o_o_o_o_o_o_x_o_o_o_l_o_o_o_o_o_o_o_o_l_o_o_o_o_o_o_o_x_o_o_o_o_x_x_x
x_x_x_o_l_o_x_x_x_x_x_x_x_x_x_x_x_x_x_x_x_x_x_x_x_x_x_x_x_x_x_x_x_x_x_x_x_x_x_x_x_x
x_x_x_l_l_o_x_x_x_x_x_x_x_x_x_x_x_x_x_x_x_x_x_x_x_x_x_x_x_x_x_x_x_x_x_x_x_x_x_x_x_x
x_x_x_o_o_o_x_x_x_x_x_x_x_x_x_x_x_x_x_x_x_x_x_x_x_x_x_x_x_x_x_x_x_x_x_x_x_x_x_x_x_x
x_x_x_x_5_x_x_x_x_x_x_x_x_x_x_x_x_x_x_x_x_x_x_x_x_x_x_x_x_x_x_x_x_x_x_x_x_x_x_x_x_x
x_x_x_o_o_o_o_l_o_o_o_o_o_o_o_o_o_o_o_x_o_o_o_o_o_o_o_o_o_o_o_o_o_o_o_o_o_o_o_x_x_x
x_x_x_o_o_o_l_o_o_o_l_o_o_o_l_l_o_o_o_4_o_o_o_o_o_o_o_o_o_o_o_o_o_o_o_o_o_o_o_x_x_x
x_x_x_o_o_o_o_o_l_o_o_o_o_o_l_o_o_o_o_x_o_o_o_o_o_o_o_o_o_o_o_o_o_o_o_o_o_o_o_x_x_x
x_x_x_x_x_x_x_x_x_x_x_x_x_x_x_x_x_x_x_x_x_x_x_x_x_x_x_x_x_x_x_x_x_x_x_x_o_o_o_x_x_x
x_x_x_x_x_x_x_x_x_x_x_x_x_x_x_x_x_x_x_x_x_x_x_x_x_x_x_x_x_x_x_x_x_x_x_x_o_o_o_x_x_x
x_x_x_x_x_x_x_x_x_x_x_x_x_x_x_x_x_x_x_x_x_x_x_x_x_x_x_x_x_x_x_x_x_x_x_x_x_3_x_x_x_x
x_x_x_x_x_x_x_x_x_x_x_x_x_x_x_x_x_x_x_x_x_x_x_x_x_x_x_x_x_x_x_x_x_x_x_x_o_o_o_x_x_x
x_x_x_o_o_o_o_o_o_o_o_o_o_o_o_o_o_o_x_o_o_o_o_o_o_o_o_o_o_o_o_o_o_o_o_o_o_o_o_x_x_x
x_x_x_o_o_o_o_o_o_o_o_o_o_o_o_o_o_o_2_o_o_o_o_o_o_o_o_o_o_o_o_o_o_o_o_o_o_o_o_x_x_x
x_x_x_o_o_o_o_o_o_o_o_o_o_o_o_o_o_o_x_o_o_o_o_o_o_o_o_o_o_o_o_o_o_o_o_o_o_o_o_x_x_x
x_x_x_o_o_o_x_x_x_x_x_x_x_x_x_x_x_x_x_x_x_x_x_x_x_x_x_x_x_x_x_x_x_x_x_x_x_x_x_x_x_x
x_x_x_x_1_x_x_x_x_x_x_x_x_x_x_x_x_x_x_x_x_x_x_x_x_x_x_x_x_x_x_x_x_x_x_x_x_x_x_x_x_x
x_x_x_o_o_o_x_x_x_x_x_x_x_x_x_x_x_x_x_x_x_x_x_x_x_x_x_x_x_x_x_x_x_x_x_x_x_x_x_x_x_x
x_x_x_o_o_o_o_o_o_o_o_o_o_o_o_o_o_o_o_o_o_o_o_o_o_o_o_o_o_o_o_o_o_o_o_o_o_o_o_x_x_x
x_x_x_o_o_o_o_o_o_o_o_o_o_o_o_o_o_o_o_o_o_o_o_o_o_o_o_o_o_o_o_o_o_o_o_o_o_o_o_x_x_x
x_x_x_o_o_o_o_o_o_o_o_o_o_o_o_o_o_o_o_o_o_o_o_o_o_o_o_o_o_o_o_o_o_o_o_o_o_o_o_x_x_x
x_x_x_x_x_x_x_x_x_x_x_x_x_x_x_x_x_x_x_x_x_x_x_x_x_x_x_x_x_x_x_x_x_x_x_x_x_x_x_x_x_x
x_x_x_x_x_x_x_x_x_x_x_x_x_x_x_x_x_x_x_x_x_x_x_x_x_x_x_x_x_x_x_x_x_x_x_x_x_x_x_x_x_x
x_x_x_x_x_x_x_x_x_x_x_x_x_x_x_x_x_x_x_x_x_x_x_x_x_x_x_x_x_x_x_x_x_x_x_x_x_x_x_x_x_x
